

 0  0  0  0 78  0  0  0  0  0  0  0  0  0  0  0  0  0  0  0  0  0  0  0  0  0  0  0  0  0  0  0 110  0  0  0  0
 4  5  0  0 78  0  0  0  0  0  0  0  0  0  0  0  0  0  0  0  0  0  0  0  0  0  0  0  0  0  0  0 110  0  0  4  5
20 21  0  0 78  0  0  0  0  0  0  0  0  0  0  0  0  0  4  5  0  0  0  0  0  0  0  0  0  0  0  0 110  0  0 20 21
20 21  0  0 78  0  0  0  0  0  0  0  0  4  5  0  0  0 36 37  0  0  0  0  0  0  0  0  0  0  0  0 110  0  0 20 21
20 21  0  0 78  0  0  0  0  0  0  0  0 20 21  0  0  0  0  0  0  0  0  0  0  0  0  0  0  0  0  0 110  0  0 20 21
20 21  0  0 78  0  0  0  0  0  0  0  0 20 21  0  0  0  0  0  0  0  4 16 16 16 16  5  0  0  0  0 110  0  0 20 21
20 21  0  0 78  0  0  4  5  0  0  0  0 20 21  0  0  0  0  0  0  0 36 52 54 53 52 37  0  0  0  0 110  0  0 20 21
20 21  0  0 78  0  0 20 21  0  0  0  0 20 21  0  0  0  0  0  0  0  0  0 20 21  0  0  0  0  0  0 110  0  0 20 21
20 38  0  0 78  0  0 22 38  0  0  0  0 22 38  0  0  0  0  0  0  0  0  0 22 38  0  0  0  0  0  0 110  0  0 22 21
20 49 16 16 16 16 16 48 49 16 16 16 16 48 49 16 16 16 16 16 16 16 16 16 48 49 16 16 16 16 16 16  16 16 16 48 21
36 52 52 52 52 52 52 52 52 52 52 52 52 52 52 52 52 52 52 52 52 52 52 52 52 52 52 52 52 52 52 52  52 52 52 52 37